Dunărea # Volga # Nipru #Rin
Brazilia# Argentina #Columbia# Venezuela
5# 6# 7# 8
Bulgaria, Serbia,Ungaria,Ucraina, Republica Moldova# Bulgaria, Ungaria, Republica Moldova# Serbia, Ucraina, Republica Moldova, Austria# Austria, Ucraina, Bulgaria, Serbia
Franta#	Elvetia#Germania# Austria
Berlin# Roma# Kiev#	Vatican
Pădurea Amazoniană#	Pădurea tropicală din Congo#	Rezervatia Biosferei Bosawas#	Pădurea tropicală Daintree
Asia#	Australia#	Antarctica#	Africa
Odesa#	Kyiv#	Prîpeat# Mariupol
Canada#	Rusia#	Brazilia# Republica Populară Chineză 
Fluviul Amazon# Fluviul Nil# Fluviul Yangtze# Fluviul Mississippi
Monaco# Vatican# Nauru#	Tuvalu
New York# 	Los Angeles# Washington DC# Chicago
Cascada Angel#	Cascada Tugela#	Cascada Trei Surori# Cascada Niagara
Africa#	Asia#	Europa#	America de Nord 
Mercur#	Venus#	Pământ#	Jupiter 
Porto#	Lisabona#	Estori#	Cascais 
Irak# Egipt# 	Algeria# Chad 
Insula Chios, Grecia# Insula Gavdos, Grecia# Insula Lemnos, Grecia#	Insula Evia, Grecia 
Capul Nordkinn, Norvegia# Capul Greco, Cipru#	Capul Rodon, Albania#	Capul Tainaron, Grecia